1 1 0 0 0 0 0 1 1 1
1 1 0 1 0 1 0 1 1 1
0 2 0 3 3 3 4 4 4 0
0 1 1 1 0 1 1 1 1 0
0 1 1 1 0 0 0 0 0 0
3 3 0 1 0 1 1 1 1 1
1 1 0 1 0 0 0 0 0 0
1 1 0 1 1 1 1 1 1 0
1 1 0 0 3 3 4 0 0 0
1 1 1 1 1 1 1 1 1 1